# Rime table
# coding: utf-8
#@/db_name  custom_phrase.txt
#@/db_type	tabledb
#
# ç”¨æ–¼ã€æœ™æœˆæ‹¼éŸ³ã€‘ç³»åˆ—è¼¸å…¥æ–¹æ¡ˆ
# ã€å°ç‹¼æ¯«ã€‘0.9.21 ä»¥ä¸Š
#
# è«‹å°‡è©²æ–‡ä»¶ä»¥UTF-8ç·¨ç¢¼ä¿å­˜çˆ²
# Rimeç”¨æˆ¶æ–‡ä»¶å¤¾/custom_phrase.txt
#
# ç¢¼è¡¨å„å­—æ®µä»¥è£½è¡¨ç¬¦ï¼ˆTabï¼‰åˆ†éš”
# é †åºçˆ²ï¼šæ–‡å­—ã€ç·¨ç¢¼ã€æ¬Šé‡ï¼ˆæ±ºå®šé‡ç¢¼çš„æ¬¡åºã€å¯é¸ï¼‰
#
# é›–ç„¶æ–‡æœ¬ç¢¼è¡¨ç·¨è¼¯è¼ƒçˆ²æ–¹ä¾¿ï¼Œä½†ä¸é©åˆå°å…¥å¤§é‡æ¢ç›®
#
# no comment

Rime	rime	3
ä¸­å·éŸ»è¼¸å…¥æ³•å¼•æ“	rime	2
http://rime.im/	rime	1
âŒ˜	cm
âŒƒ	ct	1
âŒ¥	ot
Option	ot
â‡§	sf
AC86U	ac
Apple ID	aid
AirPods	airp	2
AirPods Pro	airp	1
Apple Music	am	2
AiMesh	am	1
Apple	apple	3
ï£¿	apple	2
ï£¿ Pay	apple	1
Apple Watch	aw
Android	az
Chrome	ch
CleanMyMac X	cmm	1
Command	cm	1
Control	ct	2
>	dy	2
â‰¥	dy	1
<	xy	2
â‰¤	xy	1
Download	dl	1
å¤§è¿æ€æˆè´¸æ˜“æœ‰é™å…¬å¸	dlsc	1
é«˜æ–°æŠ€æœ¯å¼€å‘åŒºæ‹›å•†å…°æºªè°·ä¸‰æœŸ9æ ‹607	dz	1
åˆ˜åæ¸… 18699998081 å—äº¬å¸‚æµ¦å£åŒºé«˜æ–°æŠ€æœ¯å¼€å‘åŒºæ‹›å•†å…°æºªè°·ä¸‰æœŸ9æ ‹607	dz	2
Edge	edge
Enpass	enpass
ç•ªç¾½å¢™	fanqiang
Facebook	fb
Final Cut Pro	fcp
gfwlist	gfw
Google	gg
GitHub Desktop	gh	1
GitHub	gh	2
Gmail	gm
Return é”®	huichejian
Firefox	ff
macOS High Sierra	macos	2
macOS Mojave	macos	3
macOS	macos	4
macOS Sierra	macos	1
Mason	mason
iOS	ios
iTunes	itunes
koolproxy	kpr
koolshare	ks
ç¦¾æ–—å­¦ä¸Šç½‘	kxsw
Lightning to USB-C	ltc
Lightning to USB	ltu
ğŸ‚ï¸ğŸºï¸	niubi
MySQL	mysql
Markdown	md	4	
[]()	md	2
![]()	md	3
:---: | :---:	md	1
Microsoft Office	mo
Netflix	nf
WeChat	wx	
MacBook Pro	mbp
MacBook Air	mba
MacBook	macbook
Mac	mac	3
Mac Pro	mac	1
Mac mini	mac	2
æ¢…æ£®INCN	meisen	
iMac	imac	2
iMac Pro	imac	1
iPad	ipad	4
iPad Air	ipad	2	
iPad Pro	ipad	3
iPad mini	iPad	1
iPhone	af	5
iPhone X	af	4
iPhone XS Max	af	3
iPhone 11	af	2
iPhone 11 Pro	af	1
iPhone 11 Pro Max	af	0
iPod	ipod
IPTV	iptv
IPv4	ipv
IPv6	ipv
iCloud	icloud
Instagram	ins
iOS	ios
App Store	as	2
Apple Store	as	1
1password	one	2
OneDrive	one	1
Pro	pro
Plus	plus
Parallels Desktop	pd
Photoshop	ps
Quantumult	quan
Quantumult X	quanx
readme.md	rm
ScreenBar Plus	sb	1
ScreenBar	sb	2
Shadowrocket	xfj	3	
Shadowsocks	xfj	2
ShadowsocksX-NG-R8	xfj	1
Safari	sf	2
Shift	sf	1
SHIELD TV	stv
SSD	ssd
WH-1000XM2	suoniw	3
WH-1000XM3	suoniw	2
WF-1000XM3	suoniw	1
Tæ¤	txu
Type-C	tc
Telegram	tg	2
Telegram Lite	tg	1	
TeamViewer	tv
USB-C	uc
Uç›˜	upan
Wi-Fi	wifi
Windows	win
WTF	wtf	3
ä»€ä¹ˆç©æ„å„¿ï¼	wtf	2
What the fuck!	wtf	1
Xbox One	xbox
Youku	youku
YouTube	yt
masonvvip@gmail.com	yx	6
mason999@qq.com	yx	5
453058888@qq.com	yx	4
zookaka@163.com	yx	3
masonincn@gmail.com	yx	2
hedongvvip@gmail.com	yx	1
##	jj
###	jjj
**	xx
æ·¼	shuishuishui
ç„±	huohuohuo
åš	tututu
å£µ	shishishi
å­¨	zizizi
æ¯³	maomaomao
ç•¾	tiantiantian
å°›	xiaoxiaoxiao
éº¤	lululu
é±»	yuyuyu
çŒ‹	quanquanquan
éª‰	mamama
ç¾´	yangyangyang
é¾˜	longlonglong
çŸ—	zhizhizhi
ã‚	qiqiqi
æ±	shoushoushou
çŠ‡	niuniuniu


